1111111111111111111111111111111111
1010000000000000000000000000000001
1010010100000000101001000000010101
10100100100E0010P01001000000010111
100000000000C0C0000000000000000001
1111111111111111111111111111111111