11111111111111111
10K00000000000001
100010E0010C000C1
10101000101011101
10K0000000P000001
11111111111111111